importCSV=Import CSV
downloadCSV=Download CSV
downloadSelectedLocs=Download Selected Locations
downloadAllLocs=Download All Locations
openLabel=Open
closeLabel=Close
status=Status
typeLabel=Type
nameLable=Name
regionLabel=Region
planType=Plant Type
promotionLabel=Promotion
viewDetails=View Details
editLabel=Edit
closeLocation=Close Location
openLocation=Open Location
fileInformation=File Information
nameOfImportLabel=Name of Import
chooseFileLabel=Choose a file
cancelLabel=Cancel
saveLabel=Save
addLocation=Add Location
searchLabel=Search
exportWait=Please wait, we are exporting the locations.
noLocations=No locations available to export.
exportError=Export error. Please try again.
atleastOne=At least one location must be selected.
selectedDownloaded=CSV file for the selected locations has been downloaded successfully.
missingCreate=Location is currently missing from our website. We are in the process of creating it.
locationNotCreated=Requested location is not created.
fileDataUploadSuccess=location-import-status.csv file uploaded successfully
fileRequireValidation=Please select a file.
locationUpdateSuccess=Location is updated successfully
locationUpdateFailMessage=Requested location is not updated.
locationCreatedMessage=Requested location is created successfully
locationFailMessage=Requested location is not created.
warnExportSelect=Please select any location to export.
chooseFile=Choose a file
folderCreationFail=Failed to create folder
uploadFileCreationFail=Failed to upload file